¿r723¿¿i3
¿¿}¿1¿i28
}62292224
¿592223¿¿
¿¿}}}¿u¿¿